20
10
kenney_grass
100
100
1 1 1 1 1 1 1 1 1 1 1 1 1 1 1 1 1 1 1 1 
1 0 0 0 0 0 0 0 0 0 0 0 0 0 0 0 0 0 0 1 
1 0 0 0 0 0 0 0 0 0 0 0 0 0 0 0 0 0 0 1 
1 0 9 10 10 10 11 0 0 0 18 19 20 0 0 8 0 0 0 1 
1 0 0 0 0 0 0 0 0 0 0 0 0 0 0 0 0 0 0 1 
1 0 8 0 0 0 0 0 0 0 0 0 0 0 0 0 0 12 19 19 
1 0 0 0 0 18 19 20 0 0 0 0 0 0 0 0 12 13 1 1 
1 0 8 0 0 0 0 0 0 0 12 19 19 14 0 12 13 1 1 1 
1 0 0 0 0 0 0 0 0 12 13 1 1 15 19 13 1 1 1 1 
19 19 19 19 19 19 19 19 19 13 1 1 1 1 1 1 1 1 1 1 
